-----------
|s| | | | |
- - - - - -
| / / /   |
--------- -
| | |f/   |
-------|-|-